111111111
124.R.IP1
1.......1
1MIY.RIS1
111111111
