11111111
1....R.1
123.WIP1
1....S.1
1MIY1..1
11111111
