11111111
12.....1
1...4..1
1PIV...1
1MIY1..1
11111111
