11111111111111
1...........51
1............1
1..FIV.......1
1MIY1.......21
11111111111111
