11111111
12.....1
1...4..1
1R.....1
1MIY1..1
1......1
1......1
11111111
